S  #######
      #  #
#  ####  #
#        #
#  ####  #
#        #
#######  E