S  ███████
      █  █
█  ████  █
█        █
█  ████  █
█     █  
███████  E