#########
S   ##  E
### ### #
#       #
#########